{
    "size_horizontal" : 10,
    "size_vertical" : 10,
    "map" : [
        541,542,638,844,638,638,844,542,844,844,
        844,1,1,1,1,1,3,4,1,638,
        638,1,1,1,1,1,3,3,4,844,
        844,1,1,1,1,1,1,3,3,844,
        845,1,1,1,1,1,1,1,1,445,
        638,1,1,1,1,1,1,1,1,844,
        844,1,1,1,1,1,1,1,1,844,
        844,3,1,1,1,1,1,1,1,638,
        844,3,3,1,1,1,1,1,1,638,
        844,638,844,542,844,844,638,542,844,844
    ]
}